11111111111111111111111111111111111
12E22222222222222222222222222222221
10P00000000000000000000000000000CZ1
11111111111111111111111111111111111
