1111111111111111111
12E2122222222211111
11P1100000000011111
1001200000Z00011111
11110000X0000011111
10C0100000000011111
1111111111011122211
1111111111022200011
111111111100000C011
1111111111111100011
1111111111111111111
