1111111111111111111111111
122222222221E121222122221
10000000000101010001C0001
1111101000010101011110111
1222101000000001022220121
1000101001111111000000101
1001101111222222000000101
1002202221000000000000101
1000000002000111111111101
1111111010000222121222201
1222222021100000101000001
1000000000100000101000001
1010000100100000102011111
1011101110200000100022221
1022202220011100101000001
1000000000022200101111011
10100Z0000000000202222021
1010000011111000000000001
1011110022222001111111111
1022220000000002222212221
100000111111000000001C001
1111102222220111101111101
1222200000000122202222201
100000111111P100000000001
1111111111111111111111111
