111111111111111111111111111111111111111111111111111111111111
111111111111111111111111111111111111111111111111111111111111
111111111111111111111111111222222111111111111111111111111111
111111111111111111111111112000000211111111111111111111111111
11111111111111112E2122211200Z0000021122212221111111111111111
111111111111111100010001100000000001100010001111111111111111
11111111111111110001000110000000Z001100010001111111111111111
111111111111111100010001100Z00000001100010001111111111111111
111111111111111110111011111110011111110111011111111111111111
111111111111112220222022122220022221220222022211111111111111
111111111111110000000000200000000002000000000011111111111111
11111111111111000000000000000000000000C000000011111111111111
1111111111111100000000000000000000000C0000000011111111111111
1111111111111100000000000000000000000000C0000011111111111111
111111111111110000000000000000000000000000000011111111111111
111111111111111111111001110000000011100111111111111111111111
111111111111111111122002210100001012200221111111111111111111
11111111111111111110C000C10200002010000001111111111111111111
11111111111111111110000C010000000010000001111111111111111111
1111111111111111111111111101000C1011111111111111111111111111
111111111111111111111111110200002011111111111111111111111111
111111111111111111111111110000000011111111111111111111111111
11111111111111111111111111010C001011111111111111111111111111
111111111111111111111111110200002C11111111111111111111111111
111111111111111111111111110000000011111111111111111111111111
111111111111111111111111110100001011111111111111111111111111
111111111111111111111111110200002011111111111111111111111111
111111111111111111111111110000P00011111111111111111111111111
111111111111111111111111111111111111111111111111111111111111
