111111111111111
1111222E2221111
1112C00000C2111
112C0000000C211
110010000010011
110020000020011
1100000Z0000011
110010000010011
110020000020011
111C0000000C111
1111C00P00C1111
111111111111111
111111111111111
