111111111111111111111111111111
122211222222212222222221111111
10P0110CCC000200X00Z0002211111
1000110CZC0000000000Z000022111
1000110CCC0001000000000E000221
110111111111110000000000000001
120222222222211111111101111111
100000000000012222222202222221
111101111110010000000000000001
122202221110020000100100100001
100000001110000000200200200001
100000001110010000000000000001
111111111111111111111111111111
